A #############################
  # #           # # # #       #
# # # # ##### ### # # ### # ###
#   # #     #   #     # # # # #
# # # ### # ### # ### # # ### #
# # # # # # # # # # # #   #   #
# ### # ### # # # # # ### # ###
#       # # # # # # #     #   #
####### # ### ##### # ### ### #
# #   # # # # #       #       #
# ### # # # # ####### ####### #
# #         #   #   #   #   # #
# ### ### ### ##### # # ### # #
#   # #               #     # #
# # # ##### ### ####### # # ###
# #   #     # # #   #   # # # #
# # # # ### # ### ####### ### #
# # # #   #   #     # # #   # #
# ######### # # # # # # # ### #
#   #   # # # # # #       # # #
# ### ### ######### ####### # #
# #         #   # # #     # # #
### ##### ##### # # ##### # # #
# # # # #       # #         # #
# # # # ####### # # # ##### # #
#     # # #     # # #     #   #
# ### # # # ### # # # ### #####
# #   # # # #       #   # #   #
# ### # # # ### # # # ####### #
#   #     # #   # # #         
############################# B
