A #######################################
      #                 #   #     #   # #
# # # ### ####### # # ### ##### # # ### #
# # # #     # #   # #     #   # # #     #
### ##### # # # # ### ### ### ### # #####
# # # #   #   # # #   #     # # # #   # #
# # # ### # # ####### # # ### # # ### # #
#         # # #     # # #     #     #   #
# ### ####### ### ##### ### ### # ### # #
# # #     #   # #     # #       # #   # #
### ######### # ##### ######### # ### ###
#   #       # # #   #   #   #   #   #   #
# ### ##### # # # ##### # ### ##### ### #
#   # #   # # # #             # # #     #
# # # # ### # # # # ### # ##### # ##### #
# #     #   # #   #   # #   # #         #
### # # ### ####### ### ##### # ##### # #
# # # # # #     #     #   # #   # # # # #
# # ##### # ### # # ##### # ### # # # # #
#       #   #     # # # #     # #   # # #
### ### # ### ### ### # # ####### #######
#     # #   # #     #       #   #   #   #
# ##### ### ### ### # # # ### # # # # ###
#   #     # #     # # # #   # # # #     #
# ####### # ### # ### ### # # # # # #####
#     # # #   # # # # # # #   # # #   # #
# ##### # ####### # # # # ##### # ### # #
# #         #     #   # # #     # #   # #
####### ### # ####### # # ######### ### #
#   # #   # # #       # # #         #   #
# ### ####### # # ##### # # ### # # ### #
# # #   #   # # # #           # # # #   #
# # ### # # # ########### # # ### # # ###
#       # # #   #       # # # # # #     #
# ##### # # # # ### ### ##### # ####### #
#     #   # # #   # #     # #     # #   #
# ####### ### # # # ##### # # ##### # # #
# #   #       # # # #     # # #   #   # #
# # ##### ### # # # ### # # # # ##### ###
#   #       # # # # #   #       #       
####################################### B
