A #################################
    # #   #   # #           #     #
# # # ### ### # # ##### ### ### ###
# #               #     # # # #   #
# ################### # # ### ### #
# #           # #     #   #     # #
# ##### ####### # # ####### # ### #
#   #           # # #     # # #   #
####### ### ### ### # ####### # ###
#   # #   # #   #       # #       #
# ### # ############### # ### #####
#     # # # #   #   #         # # #
# ### # # # # # # ########### # # #
# # #   # #   # #   # #           #
# # ### # # # ### ### ### # ##### #
#     #   # # #       # # # #   # #
# ### ### # # ##### ### ### # ### #
#   #   #   # # # # #           # #
# ##### # # # # # # ### # # # ### #
# # #   # # # #     #   # # # # # #
### ### ########### ### ##### # # #
#   #       #   #   #       # # # #
# ### # # ### # ### # ######### # #
#     # # #   # # #             # #
### ### # # ##### # # ### # # #####
# #   # #       #   #   # # #   # #
# ########### ################# # #
# #   # #   # #       # # # # #   #
# # ### ### # # # # ### # # # # ###
#   #         # # #     #   # # # #
### ##### ####### # ### # # # # # #
# #   # # # #     # # # # # #     #
# ### # # # ####### # ##### ### ###
#                                 
################################# B